American Journal of Physics = Am. J. Phys.
Applied Optics = Appl. Opt.
Journal of Computational Physics = J. Comput. Phys.
Journal of Optics A: Pure and Applied Optics = J. Opt. A: Pure Appl. Opt.
Journal of Optics = J. Opt.
Journal of Physics A: Mathematical and Theoretical = J. Phys. A: Math. Theor.
Journal of Physics C: Solid State Physics = J. Phys. C: Solid St. Phys.
Journal of Physics D: Applied Physics = J. Phys. D: Appl. Phys.
Journal of Physics D-Applied Physics = J. Phys. D: Appl. Phys.
Journal of Physics F: Metal Physics = J. Phys. F: Metal Phys.
Journal Of The Optical Society Of America A-Optics Image Science And Vision = J. Opt. Soc. Am. A
Nature Photonics = Nature Photon.
Nature = Nature
Nature Chemistry = 
Nature Geoscience = 
Nature Materials = Nature Mater.
Nature Nanotechnology = Nature Nanotech.
Nature Physics = Nature Phys.
NRO = Nouvelle Revue d'Optique
Optics Communications = Opt. Commun.
OE = Opt. Express
Physical Review A (Atomic, Molecular, and Optical Physics) = Phys. Rev. A
Physical Review B (Condensed Matter and Materials Physics) = Phys. Rev. B
Physical Review D (Particles, Fields, Gravitation, and Cosmology) = Phys. Rev. D
Physical Review E (Statistical, Nonlinear, and Soft Matter Physics) = Phys. Rev. E
Physical Review Series I = Phys. Rev. (Series I)
Physica A Statistical Mechanics and its Applications = Physica A
Physica E Low-Dimensional Systems and Nanostructures = Physica E
Physica E-Low-Dimensional Systems \& Nanostructures = Physica E
Physica Status Solidi A-Applied Research = Phys. Status Solidi A
Physica Status Solidi B Basic Research = Phys. Status Solidi B
physica status solidi (b) = Phys. Status Solidi B
Quantum Electronics, IEEE Journal of = IEEE J. Quantum. Electron.
Applied Physics A: Materials Science & Processing = Appl. Phys. A: Mater. Sci. Process.
Applied Physics A: Materials Science and Processing = Appl. Phys. A: Mater. Sci. Process.
Applied Physics B: Lasers and Optics = Appl. Phys. B: Lasers Opt.
Electronics Letters = Electron. Lett.
Europhysics Letters = Europhys. Lett.
European Journal of Physics = Eur. J. Phys.
European Physical Journal-Applied Physics = Eur. Phys. J. Appl. Phys.
Lightwave Technology, Journal of = J. Lightw. Technol.
Journal of Microscopy = J. of Microscopy
Journal of Vacuum Science and Technology = J. Vac. Sci. Technol.
Microwave Theory and Techniques, IEEE Transactions on = IEEE T. Microw. Theory.
Photonics and Nanostructures - Fundamentals and Applications = Photonics and Nanostructures
Electron Device Letters = IEEE Electr. Device. L.
IEEE Journal of Selected Topics in Quantum Electronics = IEEE J. Sel. Topics in Quantum Electron.
IEEE Trans. Electron Devices = IEEE T. Electron. Dev.
IEEE ANTENNAS \& PROPAGATION MAGAZINE = IEEE Antennas. Propag.
IEEE Trans. Microwave Theory Tech. = IEEE T. Microw. Theory.
