AcBB = Biochim. Biophys. Acta
AcHCh = Helv. Chim. Acta
AcMat = Acta Mater.
AcOpt = Opt. Acta
AcPhS = Acta Physiol. Scand.
AcRhe = Rheol. Acta
ACSB = Am. Ceram. Soc. Bull.
AdChP = Adv. Chem. Phys.
ADIEP = Adv. Imag. Elect. Phys.
AdPoS = Adv. Polym. Sci.
AdQC = Adv. Quantum Chem.
Adsor = Adsorption
AIChE = AIChE J.
AJCh = Aust. J. Chem.
AmJPh = Am. J. Phys.
AmMin = Am. Mineral.
AnaCh = Anal. Chem.
AnBio = Anal. Biochem.
ApOpt = Appl. Opt.
ApPhA = Appl. Phys. A: Mater. Sci. Process.
ApPhB = Appl. Phys. B: Lasers Opt.
ApPhL = Appl. Phys. Lett.
ApPhy = Appl. Phys.
ApSpe = Appl. Spectrosc.
ApSS = Appl. Surf. Sci.
ArCom = Arch. Combust.
AREPS = Annu. Rev. Earth Planet. Sci.
ARNPS = Annu. Rev. Nucl. Part. Sci.
ARPC = Annu. Rev. Phys. Chem.
AtmEn = Atmos. Environ.
BBRC = Biochem. Biophys. Res. Commun.
BCB = Biochem. Cell Biol.
BioCh = Biophys. Chem.
BioJ = Biochem. J.
BiotL = Biotechnol. Lett.
BJAP = British Journal of Applied Physics
BpJ = Biophys. J.
CaJCh = Can. J. Chem.
CaJPh = Can. J. Phys.
CaRes = Cancer Res.
CatL = Catal. Lett.
ChEnC = Chem. Eng. Commun.
ChEnS = Chem. Eng. Sci.
ChGeo = Chem. Geol.
ChOpL = Chin. Opt. Lett.
ChSRv = Chem. Soc. Rev.
CJChE = Can. J. Chem. Eng.
CoFl = Combust. Flame
ColJ = Colloid J.
CoMP = Contrib. Mineral. Petrol.
Compe = Compel-The International Journal For Computation And Mathematics In Electrical And Electronic Engineering
CoPhC = Comput. Phys. Commun.
CP = Chem. Phys.
CPL = Chem. Phys. Lett.
CPLip = Chem. Phys. Lipids
CQGra = Class. Quantum Grav.
CRPhy = C. R. Phys.
CRSSM = Crit. Rev. Solid State Mater. Sci.
Cryo = Cryogenics
CryRp = Crystallogr. Rep.
CST = Combust. Sci. Technol.
DokES = Dokl. Earth Sci.
DokPC = Dokl. Phys. Chem.
DTr = Dalton Trans.
EEyeR = Exp. Eye Res.
EJPh = Eur. J. Phys
EL = Europhys. Lett.
ElL = Electron. Lett.
EnTox = Environ. Toxicol.
EPJAP = Eur. Phys. J. Appl. Phys.
EPJB = Eur. Phys. Jour. B
EPJD = Eur. Phys. Jour. D
E&PSL = Earth Planet. Sci. Lett.
ER = Environ. Res.
Fer = Ferroelectrics
FizMM = Fiz. Met. Metalloved.
FoPh = Found. Phys.
FoPhL = Found. Phys. Lett.
GBioC = Global Biogeochem. Cycles
GeCoA = Geochim. Cosmochim. Acta
GeocJ = Geochem. J.
HeaPh = Health Phys.
HECh = High Energy Chem.
HGT = Hum. Gene Ther.
Holz = Holzforschung
HPP = High Perform. Polym.
HTrEn = Heat Transfer Eng.
HyInt = Hyperfine Interact.
IAPM = IEEE Antennas. Propag.
IAWPL = IEEE Antenn. Wirel. Pr.
IComM = IEEE Commun. Mag.
IEDL = IEEE Electr. Device. L.
IEEEN = IEEE Network.
IEEES = IEEE Spectrum.
IGRSL = IEEE Geosci. Remote. S.
IISys = IEEE Intell. Syst.
IJHE = Int. J. Hydrogen Energy
IJMF = Int. J. Multiphase Flow
IJMSp = Int. J. Mass Spectrom.
IJN = Int. J. Nanosci.
IJNME = International Journal For Numerical Methods In Engineering
IJOE = IEEE J. Oceanic. Eng.
IJPAP = Indian J. Pure Appl. Phys.
IJPM = Int. J. Polym. Mater.
IJQC = Int. J. Quantum Chem.
IJQE = IEEE J. Quantum. Electron.
IJRB = Int. J. Radiat. Biol.
IJSAC = IEEE J. Sel. Area. Comm.
IJSSC = IEEE J. Solid-St. Circ.
IJT = Int. J. Thermophys.
IMGWL = IEEE Microw. Guided. W.
IMRv = Int. Mater. Rev.
InCh = Inorg. Chem.
InJPh = Indian J. Phys.
InPhT = Infrared Physics \& Technology
IPTL = IEEE Photonic. Tech. L.
IRPC = Int. Rev. Phys. Chem.
ISPL = IEEE Signal. Proc. Let.
ISPM = IEEE Signal. Proc. Mag.
IS&T = Instrum. Sci. Technol.
ITAC = IEEE T. Automat. Contr.
ITAP = IEEE T. Antenn. Propag.
ITAS = IEEE T. Appl. Supercon.
ITASS = IEEE T. Acoust. Speech.
ITBE = IEEE T. Bio-Med. Eng.
ITB = IEEE T. Broadcast.
ITCHM = IEEE T. Compon. Hybr.
ITCmp = IEEE T. Comput.
ITCom = IEEE T. Commun.
ITDEI = IEEE T. Dielect. El. In.
ITED = IEEE T. Electron. Dev.
ITEdu = IEEE T. Educ.
ITEI = IEEE T. Electr. Insul.
ITElC = IEEE T. Electromagn. C.
ITEM = IEEE T. Eng. Manage.
ITEnC = IEEE T. Energy. Conver.
ITGE = IEEE T. Geosci. Elect.
ITGRS = IEEE T. Geosci. Remote.
ITIA = IEEE T. Ind. Appl.
ITIEC = IEEE T. Ind. El. Con. In.
ITIE = IEEE T. Ind. Electron.
ITIP = IEEE T. Image. Process.
ITIT = IEEE T. Inform. Theory.
ITME = IEEE T. Mil. Electron.
ITM = IEEE T. Magn.
ITMI = IEEE T. Med. Imaging.
ITMTT = IEEE T. Microw. Theory.
ITNan = IEEE T. Nanotechnol.
ITNN = IEEE T. Neural. Networ.
ITNS = IEEE T. Nucl. Sci.
ITPAM = IEEE T. Pattern. Anal.
ITPD = IEEE T. Power. Deliver.
ITPE = IEEE T. Power. Electr.
ITPHP = IEEE T. Parts. Hyb. Pac.
ITPS = IEEE T. Plasma. Sci.
ITR = IEEE T. Reliab.
ITSE = IEEE T. Software. Eng.
ITSMC = IEEE T. Syst. Man. Cyb.
ITSP = IEEE T. Signal. Proces.
ITSTQ = IEEE J. Sel. Topics in Quantum Electron.
ITUFF = IEEE T. Ultrason. Ferr.
ITVT = IEEE T. Veh. Technol.
JAAS = J. Anal. At. Spectrom.
JAChS = J. Am. Chem. Soc.
JAerS = J. Aerosol Sci.
JaJAP = Jpn. J. Appl. Phys.
JAllC = J. Alloys Compd.
JApCr = J. Appl. Crystallogr.
JApEl = J. Appl. Electrochem.
JAP = J. Appl. Phys.
JApSp = J. Appl. Spectrosc.
JAtC = J. Atmos. Chem.
JBB = J. Bioenerg. Biomembr.
JBBM = J. Biochem. Biophys. Methods
JBC = J. Biol. Chem.
JBNMR = J. Biomol. NMR
JCA = Journal of Computational Acoustics
JCat = J. Catal.
JChEd = J. Chem. Educ.
JChPh = J. Chem. Phys.
JChS = J. Chromatogr. Sci.
JCHyd = J. Contam. Hydrol.
JCIS = J. Colloid Interface Sci.
JCoAM = Journal of Computational and Applied Mathematics
JCoB = J. Comput. Biol.
JCoCh = J. Comput. Chem.
JCoPh = J. Comput. Phys.
JCrGr = J. Cryst. Growth
JCS = J. Cluster Sci.
JDR = J. Dairy Res.
JDST = J. Dispersion Sci. Technol.
JElS = J. Electrochem. Soc.
JEMat = J. Electron. Mater.
JESRP = J. Electron Spectrosc. Relat. Phenom.
JEWA = Journal Of Electromagnetic Waves And Applications
JExB = J. Exp. Bot.
JHEP = Journal of High Energy Physics
JIST = J. Imaging Sci. Technol.
JKPS. = Journal of The Korean Physical Society
JLTP = J. Low Temp. Phys.
JLum = J. of Luminescence
JLwT = J. Lightw. Technol.
JMaCh = J. Math. Chem.
JMagR = J. Magn. Reson.
JMatR = J. Mater. Res.
JMatS = J. Mater. Sci.
JMBio = J. Mol. Biol.
JMCh = J. Mater. Chem.
JMemS = Journal of Microelectromechanical Systems
JMEP = J. Mater. Eng. Perform.
JMic = J. of Microscopy
JMMM = J. Magn. Magn. Mater.
JMolE = J. Mol. Evol.
JMOp = J. Mod. Opt.
JMoSp = J. Mol. Spectrosc.
JMoSt = J. Mol. Struct.
JMP = Journal Of Mathematical Physics
JMSB = J. Macromol. Sci., Part B: Phys.
JMSMM = J. Mater. Sci.: Mater. Med.
JNeur = J. Neurochem.
JNIS = J. Near Infrared Spectrosc.
JNuM = J. Nucl. Mater.
JOptA = J. Opt. A: Pure Appl. Opt.
JOpt = J. Opt.
JOSAA = J. Opt. Soc. Am. A
JOSAB = J. Opt. Soc. Am. B
JOSA = Journal of the Optical Society of America (1917-1983)
JPCA = J. Phys. Chem. A
JPCB = J. Phys. Chem. B
JPCM = J. Phys.: Condens. Matter
JPCRD = J. Phys. Chem. Ref. Data
JPCS = J. Phys. Chem. Solids
JPet = J. Petrol.
JPhA = J. Phys. A: Math. Theor.
JPhC = J. Phys. C: Solid St. Phys.
JPhCS = J. Phys.: Conf. Ser.
JPhD = J. Phys. D: Appl. Phys.
JPhF = J. Phys. F: Metal Phys.
JPhPh = J. Pharm. Pharmacol.
JPSJ = J. Phys. Soc. Jpn.
JPS = J. Power Sources
JRNC = J. Radioanal. Nucl. Chem.
JRPC = J. Reinf. Plast. Compos.
JRSp = J. Raman Spectrosc.
JSCh = J. Solution Chem.
JSGST = J. Sol-Gel Sci. Technol.
JSup = J. Supercond.
JTAC = J. Therm. Anal. Calorim.
JTBio = J. Theor. Biol.
JTHT = J. Thermophys. Heat Transfer
JVGR = J. Volcanol. Geotherm. Res.
JVSTA = J. Vac. Sci. Technol. A
JVSTB = J. Vac. Sci. Technol. B
JVST = J. Vac. Sci. Technol.
KiCat = Kinet. Catal.
KKR = Kagaku Kogaku Ronbunshu
Langm = Langmuir
LaPhy = Laser Physics
LChip = Lab Chip
LiCr = Liq. Cryst.
Litho = Lithos
LPB = Laser Part. Beams
MaMol = Macromolecules
MaRBu = Mater. Res. Bull.
MatL = Mater. Lett.
MCLC = Mol. Cryst. Liq. Cryst.
MCP = Mater. Chem. Phys.
MeCom = Mendeleev Commun.
MeScT = Meas. Sci. Technol.
MGM = Mol. Genet. Metab.
MiEng = Microelectron. Eng.
MiMic = Microsc. Microanal.
MinDe = Miner. Deposita
MinM = Mineral. Mag.
MinPe = Mineral. Petrol.
MiOTL = Microwave and Optical Technology Letters
MmCP = Macromol. Chem. Phys.
MMP = Mater. Manuf. Processes
MolPh = Mol. Phys.
MoSim = Mol. Simul.
MPLB = Mod. Phys. Lett. B
MSTec = Mater. Sci. Technol.
NanoL = Nano Lett.
Nanot = Nanotechnology
NaPho = Nature Photon.
NAR = Nucleic Acids Res.
NatMa = Nat. Mater.
NatNa = Nature Nanotech.
NatPh = Nature Phys.
Natur = Nature
NeuL = Neurosci. Lett.
NJCh = New J. Chem.
NPhS = Nature Physical Science
NROpt = Nouvelle Revue d'Optique
NucFu = Nucl. Fusion
NucTe = Nucl. Technol.
NuEnD = Nucl. Eng. Des.
NuPhA = Nucl. Phys. A
NuPhB = Nucl. Phys. B
NW = Naturwissenschaften
OERv = Opto-Electronics Review
OExpr = Opt. Express
OptCo = Opt. Commun.
OptEn = Opt. Eng.
OptL = Opt. Lett.
OptMa = Optical Materials
OptPN = Opt. Photon. News
OptSp = Opt. Spectrosc.
OQE = Opt. Quantum. Electron.
OrGeo = Org. Geochem.
OxM = Oxid. Met.
OzSE = Ozone: Sci. Eng.
PAN = Phys. At. Nucl.
PCL = Phys. Chem. Liq.
PCM = Phys. Chem. Miner.
PcPb = Photochem. Photobiol.
PCPhy = Plant Cell Physiol.
PCPP = Plasma Chem. Plasma Process.
PDiff = Powder Diffr.
PhFl = Phys. Fluids
PhLA = Phys. Lett. A
PhLB = Phys. Lett. B
PhNan = Photonics and Nanostructures
PhPl = Phys. Plasmas
PhRvA = Phys. Rev. A
PhRvB = Phys. Rev. B
PhRvC = Phys. Rev. C
PhRvD = Phys. Rev. D
PhRvE = Phys. Rev. E
PhrvI = Phys. Rev. (Series I)
PhRvL = Phys. Rev. Lett.
PhSS = Phys. Solid State
PhyA = Physica A
PhyBC = Physica B+C
PhyB = Physica B
PhyC = Physica C
PhyD = Physica D
PhyE = Physica E
PhyS = Phys. Scr.
PLoSB = PLoS Biol.
PLoSG = PLoS Genet.
PLSCB = PLoS Comput. Biol.
PMagL = Philos. Mag. Lett.
PMag = Philos. Mag.
PoCom = Polym. Compos.
Poly = Polymer
POrCo = Prog. Org. Coat.
PPTEn = Polym.-Plast. Technol. Eng.
PreR = Precambrian Res.
PSSAR = Phys. Status Solidi A
PSSBR = Phys. Status Solidi B
PsynR = Photosynth. Res.
QuEle = Quantum Electron.
RaPC = Radiat. Phys. Chem.
RaRe = Radiat. Res.
REDS = Radiat. Eff. Defects Solids
RoJPh = Rom. J. Phys.
RScI = Rev. Sci. Instrum.
RuCRv = Russ. Chem. Rev.
RvMP = Rev. Mod. Phys.
Sci = Science
ScTEn = Sci. Total Environ.
Semic = Semiconductors
SJMet = Scand. J. Metall.
SpecL = Spectrosc. Lett.
SRL = Surf. Rev. Lett.
SSCom = Solid State Commun.
SSIon = Solid State Ionics
SSNMR = Solid State Nucl. Magn. Reson.
SSSAJ = Soil Sci. Soc. Am. J.
SSSci = Solid State Sci.
SS&T = Sep. Sci. Technol.
SuCT = Surf. Coat. Technol.
SuMi = Superlattices Microstruct.
SurIA = Surf. Interface Anal.
SurSc = Surf. Sci.
SurSR = Surf. Sci. Rep.
SuScT = Supercond. Sci. Technol.
SvPhU = Sov. Phys. Uspekhi
SynMe = Synth. Met.
TePhL = Tech. Phys. Lett.
ToCat = Top. Catal.
TSF = Thin Solid Films
Ultmi = Ultramicroscopy
Vacuu = Vacuum
Wear = Wear
WRCM = Waves in Random and Complex Media
